wwwwwwwwwwwwwwwwwwwww
wsw        ww      w  
w w       ww        w
w w                 w
w w     ww          w
w w    ww           w
w w   ww    w  w    w
w w  ww     w  w    w
w w ww            e w
w www  e  ww    ww  w
w www      ww  ww   w
w w ww      wwww  f w
w w                 w
w w   ww            w
w w    ww           w
w w     ww          w
w w   e  ww         w
w w  e    ww        w
w w        ww       w
w           ww      w
wwwwwwwwwwwwwwwwwwwww