wwwwwwwwwwwwwwwwwwwww
ws                  w  
w                   w
w                   w
w                   w
w                   w
w                   w
w     e             w
w                   w
w                   w
w                   w
w                   w
w                   w
w                   w
w             e     w
w                   w
w                   w
w                   w
w                   w
w                 f w
wwwwwwwwwwwwwwwwwwwww