wwwwwwwwwwwwwwwwwwwww
w f                 w  
w           wwww    w
w   wwwwwwwww  ww   w
w   w           w   w
w   w wwwwwwwww w   w
w eww w       w w   w
w ew  w wwwww w w   w
w ew w  w  sw w w   w
w ew w  w www w w   w
w ew  w w     w w   w
w ew  w wwwwwww w   w
w ew  w         w   w
w ew  wwwwwwwwwww   w
w ew                w
w e w               w
w e  w              w
w e   w             w
w e    wwwwwwwwww   w
w e                 w
wwwwwwwwwwwwwwwwwwwww