wwwwwwwwwwwwwwwwwwwww
ws                  w  
w                   w
w                   w
w                   w
w                   w
w                   w
w                   w
w                   w
w                   w
w                   w
w                   w
w                   w
w                   w
w                   w
w                   w
w                   w
w                   w
w                   w
w                 f w
wwwwwwwwwwwwwwwwwwwww