wwwwwwwwwwwwwwwwwwwww
weeee ee w       s  w  
weeee   w w         w
weeee  w   w        w
weeee w     w       w
weeeew       w      w
weeew         w     w
weew           w    w
w w  e          w   w
w             e     w
w   w           wwwww
w    w  e      w f  w
w     w       w     w
w   e  w     w      w
w       w   w       w
w        w w        w
w    e    w         w
w              e    w
w                   w
w                   w
wwwwwwwwwwwwwwwwwwwww